10000000000001
10000000000001
10000000000001
10000000000001
10000000000001
10000000000001
10000000000001
10000005555501
10555550000001
10000000000001
10000000000001
11111111111111