---------------------1-----1
---------------------1-----1
-111111111111111111111----r111111111111111-
-1----------------1------r---------------1-
-1----------------1-----r----------------1-
-1---------------------r-----------------1-
-1--------------------r------------------1-
-1-------------------r-------------------1-
-155----------------r--------------------1-
-1--------cc-------r---------------------1-
-1l55555511111111111---------------------1-
-1-l-----1-------------------------------1-
-1--l----1-------------------------------1-
-1---l---111111111111111111111111111111111-
-1----l----------------------------------1-
-1-----l---------------------------------1-
-1------l--------------------------------1-
-111111111111111111111111111111111555555r1-
-1----------------X--------------------r-1-
-1----------------X-------------------r--1-
-1--5555--5555--111------------------r---1-
-1----------------1-----------------r----1-
-1-55-------------1----------------r-----1-
-1----------------1---------------r------1-
-1--55----------7----------------r-------1-
-1-----------p------------------r--------1-
-1l555555555555551111111111111111111111111-
-11l-------------------------------------1-
-1-1l------------------------------------1-
-1--1l-----------------------------------1-
-1---1l----555---111---555---555---------1-
-1----1l----------1----------------------1-
-1-----1l---------1--------------55------1-
-1------1l---7---------------------------1-
-1-------1l------p-----------------55----1-
-1--------111111111l---------------------1-
-1-----------------1l-----------------5551-
-1------------------1l-------------------1-
-1-------------------1l--------7---555---1-
-1--------------------1l--------p--------1-
-111111111111111111111555555555555555555r1-
-1-------------------------------------r11-
-1------------------------------------r1-1-
-1-----------------------------------r1--1-
-1--------------X-------------------r1---1-
-1--------------X---------7--------r1----1-
-1--------------X----p------------r1-----1-
-11111111111111111111111111111111111111111-
-
-