10000000000000000000000000000000000000000000000000000000000111111111111111111111111111111111111111111111111111111111000000000000000000000000000000000000000000000000000000000000000
10000000000000000000000000000000000000000000000000000000000100000000000000000000000000000000000000000000000000000001000000000000000000000000000000000000000000000000000000000000001
10000000000000000000000000000000000000000000000000000000000100000000000000000000000000000000000000000000000000000001000000000000000000000000000000000000000000000000000000000000001
10000000000000000000000000000000000000000000000000000000000100000000000000000000000000040000000000000000000000000001000000000000000000000000000000000000000000000000000000000000001
10000000000000000000000000000000000000000000000000000000000100000000000000000000000000000000000000000000000000000001000000000000000000000000000000000000000000000000000000000000001
10000000000000000000000000000000000000000000000000000000000100000000000000000000000000000011111100111111111000000001000000000000000000000000000000000000000000000000000000000000001
10000000000000000000000000000000000000000000000000000000000100000000055555000000000000000000000000000000001110000001000000000000000000000000000000000000000000000000000000000000001
10000000000000000000000000000000000000000000000000000000000155500000000100000001111111000000000000000000010000000001000000000000000000000000000000000000000000000000000000000000001
10000000000000000000000000000000000000000000000000000000000100000000000100000000000001110000000000000000010000000001000000000000000000000000000000000000000000000000000000000000001
10000000000000000000000000000000000000000000000000000000000100000000000100000000000000000011111110000000010000005551000000000000000000000000000000000000000000000000000000000000001
10000000000000000000000000000000000000000000000000000000000100000005555100000000000000000000000000000000100000000001000000000000000000000000000000000000000000000000000000000000001
10000000000000000000000000000000000000000000000000000000000100000000000100000000000000000000000000000000100000000001000000000000000000000000000000000000000055555555555555555555551
10000000000006000022220000000000000000000000000000000000000100000000000100000000000000000000000000000000101111110000000000000000000000000000000000000000000400000000000000001000000
10000000000000001111111000000000000000000002220000000000000155500000000100000000000000000000000000000000000000010000000000000000000000000000000000000000000000000000000000001000000
100000000000000000000000002222iiii2200000001112222000000000000000000000100000000004000000000000000000000000000010000000000000300000000000000000000555555000000000000000000001000000
10000000000000000000000011111111111111100000001111100011100000000005555100000000000000000000000000000000000000011111000000000000000000000000000000000000000000000000000000001000000
10000000000000000000000010000000000000010003000000000011100000000000000000000000000000000000000000000003000000000000000022222222222000000000000000000000000000000000000000001000000
100222222222b2222222222210000000000000001000000000000011100000000000000000000000000000000000000000000000000000000000000011111111111111111111111111111111111111111111111111111000000
11111111111111111111111110000000000000000111111111111111111111111111111111111111111111111111111111111111111111111111111100000000000000000000000000000000000000000000000000000000000