111111111111111111111111111111111111111111111111111111111111111111111111111111111111111111111111111111111111
1------------1-------------------1-------------------------------------------------------------------------1
1------------1-------------------1---------6-------------------------6-------------------------------------1
1------------1-------------------1----------------------6------------------------6-------------------------1
1------------1-------------------1-------------------------------------------------------------------------1
1------------1-------------------1-------5555555555---------55555555---------------------------------4-----1
1------------1-------------------1-------------------------------------55555555555------111----------------1
1------------1------------------------555555------55555555-------------------------555----1111111----B-R---1
1------------1------55555551------------------------------------5555------111-------------------111111111111111
1------------1-------------1111111111----------------------------------------1111-----------------------------1
1------------1--5555-------1--------------------------11----111------------------1111-------------------------1
1------------1-------------1----------11----------------------------------------------------------------------1
1111111------1555555-------1----------------11----11---------------------------------11111--------------------1
1------555--------4---1111111------------------------------------------------------------1111111111-----------1
1---------------------------1---------------------------------------------------------------------1111111111111
1---------1111111111--------1---------------------------------------------------------------------------------1
1---------------------------1---------------------------------------------------------------------------------1----