-
--1111111111111111111--
--1-----------------1--
--1-----------------1--
--1-----------------1--
--1-----------------1--
--111111111111------1--
--1-----------5-----1--
--1--------4---5----1--
--1-------------5---1--
--1--------------5--1--
--1111111111111111111--