10000000000000000000001
10000000000000000000001
10000000000000000000001
10000000000000000000001
10000000000V00000000001
10000000000000000000001
10055555555555555555001
10000000000000000000001
10000000000000000000001
11111111111111111111111