-
--1111111111111111111--
--1-----------------1--
--1-----------------1--
--1-----------------1--
--1-----------------1--
--15555555555555555r1--
--1---------------r11--
--1--------------r1-1--
--1-------------r1--1--
--1------------r1---1--
--1111111111111111111--