-
1-------------------------------------------------------------1
1-------------------------------------------------------------1
1-------------------------------------------------------------1
1-------------------------------------------------------------1
1----------1--------------------------------------------------1
1----------1--------------------------------------------------1
1----------1---------------------55555555---------------------1
1----------1-------------------------------------1------------1
1111111111111111111-----111111-------------------1------------1
1------------------------------------------------1------------1
1------------------------------------1111--------1------------1
1--------------------------------------------111111111--------1
1-------------------------------------------------------------1
1---------------------------------------------------------11111
1---------------------------------------------------------1---1
1---------------------------------------------------------1---1
1-----------------------------------4----------------4----1---1
1---------------------------------------------------------1---1
1---------------------------11111111--------1111----------1---1
1---------------------------11111111--------1111----------1---1
1---------------------------11111111----------------------11111
1--------------------111111111111111--------------------------1
1--------------------111111111111111--------------------------1
1--------------------111111111111111--------------------------1
1--------------------111111111111111--------------------------1
1----------1111-----------------------------------------------1
11---------1111-----------------------------------------------1
11---------1111-----------------------------------------------1
11---------1111-----------------------------------------------1
11----111111111-----------------------------------------------1
11----111111111-----------------------------------------------1
1111------------------------------------------------1---------1
1111------------------------------------------------1---------1
11111111111----------4---------------------4--------1---------1
1---------1-----------------------------------------1---------1
111111111111111--------1111-----1111-----1111111111111111111111