000000000000000000000
000000000000000000000
000000000000000000000
000000000000000000000
000000000000000000000
002000000000000000220
111100000011100001111
000000000000000010000
000000000000000100000
001122000002001000000
111111101111110000000
100001101111110000000
