0000000000000000000000
0000000000000000000000
0000000000000000000000
0110000000000000000001
0000000000000000000110
0000000000000000000000
0001110000011100000000
0110000000000011100300
0000000000000000000000
0000300002200000000022
0020000011111111100111
0111111110000000111111