1------------1
1------------1
1------------1
1------------1
1------------1
1------------1
1------------1
1------55555-1
1-55555------1
1------------1
1------------1
11111111111111